Rk,Player,Pos,Age,Tm,G,GS,MP,FG,FGA,FG%,3P,3PA,3P%,2P,2PA,2P%,eFG%,FT,FTA,FT%,ORB,DRB,TRB,AST,STL,BLK,TOV,PF,PTS
1,Arron Afflalo\afflaar01,SG,25,DEN,3,3,85,12,34,.353,3,12,.250,9,22,.409,.397,7,8,.875,0,9,9,7,0,0,3,10,34
2,LaMarcus Aldridge\aldrila01,PF,25,POR,6,6,258,53,115,.461,0,0,,53,115,.461,.461,19,24,.792,16,29,45,8,8,10,9,19,125
3,Malik Allen\allenma01,PF,32,ORL,1,0,7,0,1,.000,0,0,,0,1,.000,.000,1,2,.500,0,1,1,0,0,0,0,2,1
4,Ray Allen\allenra02,SG,35,BOS,9,9,361,57,109,.523,32,56,.571,25,53,.472,.670,24,25,.960,5,29,34,22,11,1,10,21,170
5,Tony Allen\allento01,SG,29,MEM,13,13,350,43,101,.426,1,7,.143,42,94,.447,.431,27,41,.659,15,23,38,20,25,5,24,43,114
6,Chris Andersen\anderch01,C,32,DEN,5,0,73,7,11,.636,0,0,,7,11,.636,.636,10,14,.714,5,9,14,3,3,7,3,8,24
7,Ryan Anderson\anderry01,PF,22,ORL,6,0,147,8,30,.267,6,20,.300,2,10,.200,.367,6,6,1.000,10,17,27,3,5,1,1,16,28
8,Carmelo Anthony\anthoca01,SF,26,NYK,4,4,156,33,88,.375,9,26,.346,24,62,.387,.426,29,34,.853,13,28,41,19,5,3,13,16,104
9,Joel Anthony\anthojo01,C,28,MIA,21,13,575,18,49,.367,0,0,,18,49,.367,.367,22,31,.710,35,62,97,10,8,38,13,54,58
10,Gilbert Arenas\arenagi01,PG,29,ORL,5,0,81,18,42,.429,3,12,.250,15,30,.500,.464,4,6,.667,4,10,14,12,1,1,6,14,43
11,Trevor Ariza\arizatr01,SF,25,NOH,6,6,241,35,85,.412,7,21,.333,28,64,.438,.453,16,22,.727,7,32,39,20,8,3,7,16,93
12,Hilton Armstrong\armsthi01,C,26,ATL,8,0,35,1,5,.200,0,0,,1,5,.200,.200,3,6,.500,4,6,10,1,3,0,2,7,5
13,Darrell Arthur\arthuda01,PF,22,MEM,13,0,201,39,85,.459,1,1,1.000,38,84,.452,.465,13,17,.765,14,15,29,7,7,12,12,30,92
14,Omer Asik\asikom01,C,24,CHI,15,0,148,6,13,.462,0,0,,6,13,.462,.462,3,10,.300,10,21,31,1,2,8,7,21,15
15,J.J. Barea\bareajo01,PG,26,DAL,21,3,390,72,172,.419,16,50,.320,56,122,.459,.465,27,34,.794,8,31,39,71,6,0,23,28,187
16,Matt Barnes\barnema02,SF,30,LAL,10,0,131,15,38,.395,2,12,.167,13,26,.500,.421,4,7,.571,11,17,28,5,7,2,6,23,36
17,Earl Barron\barroea01,C,29,POR,1,0,0,0,0,,0,0,,0,0,,,0,0,,0,0,0,0,0,0,0,0,0
18,Brandon Bass\bassbr01,PF,25,ORL,6,6,139,16,38,.421,0,0,,16,38,.421,.421,12,13,.923,12,13,25,2,3,5,7,7,44
19,Tony Battie\battito01,C,34,PHI,5,0,38,3,7,.429,0,0,,3,7,.429,.429,1,2,.500,2,8,10,0,0,3,1,5,7
20,Shane Battier\battish01,SF,32,MEM,13,0,339,29,66,.439,8,29,.276,21,37,.568,.500,6,9,.667,17,35,52,15,7,6,6,27,72
21,Nicolas Batum\batumni01,SF,22,POR,6,0,151,19,46,.413,7,26,.269,12,20,.600,.489,3,4,.750,1,9,10,8,5,5,7,14,48
22,Marco Belinelli\belinma01,SG,24,NOH,6,6,173,23,63,.365,8,26,.308,15,37,.405,.429,4,4,1.000,0,5,5,4,5,0,4,12,58
23,Mike Bibby\bibbymi01,PG,32,MIA,20,20,415,27,96,.281,17,66,.258,10,30,.333,.370,2,4,.500,5,31,36,23,11,6,17,30,73
24,Chauncey Billups\billuch01,PG,34,NYK,1,1,35,3,11,.273,2,6,.333,1,5,.200,.364,2,2,1.000,0,2,2,4,0,0,3,2,10
25,DeJuan Blair\blairde01,PF,21,SAS,4,0,50,7,21,.333,0,0,,7,21,.333,.333,3,5,.600,9,4,13,2,0,1,2,6,17
26,Steve Blake\blakest01,PG,30,LAL,9,0,145,7,23,.304,6,18,.333,1,5,.200,.435,0,0,,1,13,14,20,5,0,5,8,20
27,Keith Bogans\boganke01,SG,30,CHI,16,16,307,28,69,.406,25,59,.424,3,10,.300,.587,1,4,.250,4,16,20,12,10,3,7,26,82
28,Matt Bonner\bonnema01,PF,30,SAS,6,0,123,12,25,.480,6,18,.333,6,7,.857,.600,8,10,.800,7,12,19,2,1,1,1,18,38
29,Carlos Boozer\boozeca01,C,29,CHI,16,16,507,77,178,.433,0,1,.000,77,177,.435,.433,48,60,.800,40,115,155,28,9,7,28,49,202
30,Chris Bosh\boshch01,PF,26,MIA,21,21,834,138,291,.474,0,4,.000,138,287,.481,.474,114,140,.814,47,131,178,23,14,19,40,48,390
31,Elton Brand\brandel01,PF,31,PHI,5,5,185,34,62,.548,0,0,,34,62,.548,.548,10,13,.769,12,30,42,3,2,6,4,21,78
32,Corey Brewer\breweco01,SG,24,DAL,6,0,23,4,9,.444,1,3,.333,3,6,.500,.500,0,0,,0,2,2,1,4,0,2,5,9
33,Ronnie Brewer\brewero02,SG,25,CHI,16,0,260,24,50,.480,3,7,.429,21,43,.488,.510,13,17,.765,7,27,34,15,12,6,4,14,64
34,Shannon Brown\brownsh01,SG,25,LAL,10,0,166,28,61,.459,7,25,.280,21,36,.583,.516,9,14,.643,5,14,19,7,6,2,9,10,72
35,Kobe Bryant\bryanko01,SG,32,LAL,10,10,354,83,186,.446,12,41,.293,71,145,.490,.478,50,61,.820,8,26,34,33,16,3,31,23,228
36,Rasual Butler\butlera01,SG,31,CHI,3,0,7,1,1,1.000,1,1,1.000,0,0,,1.500,0,0,,0,1,1,0,0,0,0,0,3
37,Andrew Bynum\bynuman01,C,23,LAL,10,10,320,57,105,.543,0,0,,57,105,.543,.543,30,36,.833,36,60,96,8,5,14,20,33,144
38,Marcus Camby\cambyma01,C,36,POR,6,6,167,10,22,.455,1,1,1.000,9,21,.429,.477,0,2,.000,18,40,58,8,4,9,5,18,21
39,Brian Cardinal\cardibr01,SF,33,DAL,9,0,37,3,4,.750,3,4,.750,0,0,,1.125,1,2,.500,0,3,3,2,1,0,3,8,10
40,Anthony Carter\cartean01,PG,35,NYK,4,0,49,8,15,.533,1,3,.333,7,12,.583,.567,2,2,1.000,2,6,8,6,2,1,4,1,19
41,Mario Chalmers\chalmma01,PG,24,MIA,21,1,511,54,124,.435,32,84,.381,22,40,.550,.565,23,32,.719,4,36,40,44,27,1,28,48,163
42,Tyson Chandler\chandty01,C,28,DAL,21,21,680,57,98,.582,0,0,,57,98,.582,.582,53,78,.679,79,114,193,8,13,19,14,77,167
43,Wilson Chandler\chandwi01,SF,23,DEN,5,2,115,8,29,.276,1,7,.143,7,22,.318,.293,7,9,.778,2,20,22,2,3,4,4,15,24
44,Earl Clark\clarkea01,SF,23,ORL,1,0,6,1,3,.333,0,0,,1,3,.333,.333,0,0,,2,2,4,1,1,1,0,0,2
45,Jason Collins\collija04,C,32,ATL,12,9,158,9,14,.643,0,0,,9,14,.643,.643,3,8,.375,6,11,17,1,5,3,5,31,21
46,Darren Collison\collida01,PG,23,IND,5,5,146,18,46,.391,4,6,.667,14,40,.350,.435,7,11,.636,4,9,13,20,5,2,9,7,47
47,Nick Collison\collini01,C,30,OKC,17,0,413,48,76,.632,0,0,,48,76,.632,.632,18,23,.783,47,51,98,15,15,15,13,63,114
48,Mike Conley\conlemi01,PG,23,MEM,13,13,507,71,183,.388,11,37,.297,60,146,.411,.418,44,53,.830,7,43,50,83,14,3,30,39,197
49,Daequan Cook\cookda02,SG,23,OKC,17,0,195,22,56,.393,16,46,.348,6,10,.600,.536,4,4,1.000,1,26,27,1,3,0,7,17,64
50,Jamal Crawford\crawfja01,SG,30,ATL,12,0,358,61,155,.394,21,60,.350,40,95,.421,.461,42,51,.824,1,15,16,30,9,4,16,17,185
51,Glen Davis\davisgl01,C,25,BOS,9,0,191,18,46,.391,0,1,.000,18,45,.400,.391,8,11,.727,7,25,32,8,3,0,9,21,44
52,Luol Deng\denglu01,SF,25,CHI,16,16,687,98,230,.426,22,68,.324,76,162,.469,.474,52,62,.839,27,79,106,43,24,10,26,40,270
53,Toney Douglas\douglto01,SG,24,NYK,4,3,112,15,41,.366,7,18,.389,8,23,.348,.451,6,6,1.000,2,11,13,9,2,0,4,12,43
54,Chris Duhon\duhonch01,PG,28,ORL,1,0,4,1,2,.500,1,2,.500,0,0,,.750,2,2,1.000,0,0,0,0,0,0,0,0,5
55,Tim Duncan\duncati01,C,34,SAS,6,6,212,33,69,.478,0,0,,33,69,.478,.478,10,16,.625,16,47,63,16,3,15,18,17,76
56,Mike Dunleavy\dunlemi02,SG,30,IND,5,0,72,7,20,.350,3,10,.300,4,10,.400,.425,8,12,.667,0,6,6,8,4,0,1,3,25
57,Kevin Durant\duranke01,SF,22,OKC,17,17,722,155,345,.449,37,109,.339,118,236,.500,.503,140,167,.838,18,121,139,48,16,19,42,52,487
58,Patrick Ewing\ewingpa02,SF,26,NOH,2,0,2,1,1,1.000,1,1,1.000,0,0,,1.500,0,0,,0,0,0,0,0,0,0,0,3
59,Raymond Felton\feltora01,SG,26,DEN,5,0,152,18,50,.360,4,16,.250,14,34,.412,.400,18,24,.750,0,9,9,21,6,0,10,10,58
60,Rudy Fernandez\fernaru01,SG,25,POR,6,0,81,4,18,.222,3,10,.300,1,8,.125,.306,6,9,.667,2,10,12,5,2,1,2,7,17
61,Landry Fields\fieldla01,SG,22,NYK,4,4,71,3,15,.200,0,4,.000,3,11,.273,.200,1,6,.167,1,4,5,5,2,3,4,0,7
62,Derek Fisher\fishede01,PG,36,LAL,10,10,325,29,67,.433,7,17,.412,22,50,.440,.485,17,21,.810,1,26,27,36,14,2,8,25,82
63,Gary Forbes\forbega01,SF,25,DEN,1,0,2,0,1,.000,0,0,,0,1,.000,.000,0,0,,0,1,1,0,0,0,0,0,0
64,T.J. Ford\fordtj01,PG,27,IND,2,0,14,3,3,1.000,1,1,1.000,2,2,1.000,1.167,0,0,,0,1,1,2,0,0,2,0,7
65,Jeff Foster\fosteje01,C,34,IND,5,0,93,7,12,.583,0,0,,7,12,.583,.583,3,8,.375,10,14,24,4,2,4,5,14,17
66,Danilo Gallinari\gallida01,SF,22,DEN,5,5,148,19,44,.432,7,15,.467,12,29,.414,.511,15,21,.714,1,16,17,10,4,0,7,17,60
67,Kevin Garnett\garneke01,PF,34,BOS,9,9,328,56,127,.441,0,1,.000,56,126,.444,.441,22,29,.759,21,77,98,23,17,9,19,27,134
68,Marc Gasol\gasolma01,C,26,MEM,13,13,519,72,141,.511,0,2,.000,72,139,.518,.511,51,73,.699,41,105,146,29,14,28,26,44,195
69,Pau Gasol\gasolpa01,C,30,LAL,10,10,358,47,112,.420,1,2,.500,46,110,.418,.424,36,45,.800,32,46,78,38,4,17,17,33,131
70,Paul George\georgpa01,SG,20,IND,5,5,133,10,33,.303,3,13,.231,7,20,.350,.348,7,8,.875,5,20,25,5,7,10,7,11,30
71,Taj Gibson\gibsota01,PF,25,CHI,16,0,284,43,76,.566,0,1,.000,43,75,.573,.566,9,15,.600,26,40,66,9,5,22,14,32,95
72,Manu Ginobili\ginobma01,SG,33,SAS,5,5,174,31,70,.443,9,28,.321,22,42,.524,.507,32,41,.780,2,18,20,21,13,3,17,13,103
73,Danny Granger\grangda01,SF,27,IND,5,5,183,43,90,.478,8,23,.348,35,67,.522,.522,14,16,.875,6,22,28,16,6,1,7,12,108
74,Aaron Gray\grayaa01,C,26,NOH,6,0,87,9,13,.692,0,0,,9,13,.692,.692,3,8,.375,3,18,21,2,2,2,5,13,21
75,Danny Green\greenda02,SG,23,SAS,4,0,7,2,6,.333,1,4,.250,1,2,.500,.417,0,0,,0,1,1,2,1,1,1,1,5
76,Jeff Green\greenje02,SF,24,BOS,9,0,173,23,53,.434,7,16,.438,16,37,.432,.500,13,18,.722,6,18,24,2,5,4,12,20,66
77,Willie Green\greenwi01,SG,29,NOH,6,0,84,14,36,.389,2,9,.222,12,27,.444,.417,4,7,.571,1,4,5,4,2,0,3,14,34
78,Hamed Haddadi\haddaha01,C,25,MEM,9,0,31,3,10,.300,0,1,.000,3,9,.333,.300,5,6,.833,3,5,8,0,0,5,2,7,11
79,Tyler Hansbrough\hansbty01,PF,25,IND,5,5,164,20,60,.333,0,0,,20,60,.333,.333,16,18,.889,13,14,27,5,6,0,9,13,56
80,James Harden\hardeja01,SG,21,OKC,17,0,537,66,139,.475,23,76,.303,43,63,.683,.558,66,80,.825,10,81,91,61,21,13,28,48,221
81,Al Harrington\harrial01,PF,30,DEN,5,0,70,10,22,.455,5,10,.500,5,12,.417,.568,3,4,.750,1,6,7,5,3,0,4,7,28
82,Udonis Haslem\hasleud01,PF,30,MIA,12,0,290,27,68,.397,0,0,,27,68,.397,.397,9,10,.900,13,41,54,9,6,4,11,31,63
83,Spencer Hawes\hawessp01,C,22,PHI,5,5,98,12,33,.364,0,1,.000,12,32,.375,.364,2,4,.500,5,14,19,9,0,2,2,11,26
84,Brendan Haywood\haywobr01,C,31,DAL,18,0,275,18,31,.581,0,0,,18,31,.581,.581,20,43,.465,34,39,73,4,2,18,13,48,56
85,Roy Hibbert\hibbero01,C,24,IND,5,5,132,20,45,.444,0,0,,20,45,.444,.444,12,17,.706,15,19,34,3,2,9,13,21,52
86,Nene Hilario\hilarne01,C,28,DEN,5,5,162,22,46,.478,0,0,,22,46,.478,.478,27,48,.563,14,31,45,8,5,4,8,17,71
87,George Hill\hillge01,PG,24,SAS,6,1,189,20,50,.400,4,15,.267,16,35,.457,.440,26,30,.867,5,25,30,14,9,2,8,15,70
88,Kirk Hinrich\hinriki01,PG,30,ATL,6,6,173,26,52,.500,8,19,.421,18,33,.545,.577,1,1,1.000,1,13,14,16,7,2,4,21,61
89,Jrue Holiday\holidjr01,PG,20,PHI,5,5,188,24,58,.414,11,21,.524,13,37,.351,.509,12,15,.800,3,16,19,28,10,2,11,10,71
90,Al Horford\horfoal01,C,24,ATL,12,12,468,58,137,.423,0,2,.000,58,135,.430,.423,20,26,.769,25,90,115,42,5,12,17,33,136
91,Eddie House\houseed01,SG,32,MIA,7,0,48,4,17,.235,3,10,.300,1,7,.143,.324,0,0,,1,4,5,1,4,0,4,6,11
92,Dwight Howard\howardw01,C,25,ORL,6,6,258,51,81,.630,0,1,.000,51,80,.638,.630,60,88,.682,27,66,93,3,4,11,33,25,162
93,Juwan Howard\howarju01,PF,37,MIA,11,0,60,4,9,.444,0,0,,4,9,.444,.444,9,13,.692,3,7,10,1,0,0,2,8,17
94,Serge Ibaka\ibakase01,PF,21,OKC,17,17,490,67,145,.462,0,1,.000,67,144,.465,.462,33,40,.825,47,77,124,3,4,52,21,64,167
95,Andre Iguodala\iguodan01,SF,27,PHI,5,5,182,22,52,.423,3,14,.214,19,38,.500,.452,10,14,.714,7,28,35,34,5,2,14,16,57
96,Zydrunas Ilgauskas\ilgauzy01,C,35,MIA,9,8,104,14,30,.467,0,0,,14,30,.467,.467,4,6,.667,15,17,32,3,0,3,9,16,32
97,Didier Ilunga-Mbenga\mbengdj01,C,30,NOH,5,0,26,2,2,1.000,0,0,,2,2,1.000,1.000,1,2,.500,2,3,5,1,2,3,1,7,5
98,Royal Ivey\iveyro01,SG,29,OKC,2,0,6,2,2,1.000,2,2,1.000,0,0,,1.500,0,0,,0,1,1,1,0,0,0,0,6
99,Jarrett Jack\jackja01,SG,27,NOH,6,0,111,12,34,.353,0,5,.000,12,29,.414,.353,11,16,.688,1,14,15,13,1,1,8,4,35
100,LeBron James\jamesle01,SF,26,MIA,21,21,922,174,373,.466,30,85,.353,144,288,.500,.507,119,156,.763,34,142,176,123,35,25,66,56,497
101,Richard Jefferson\jefferi01,SF,30,SAS,6,6,176,12,31,.387,6,17,.353,6,14,.429,.484,9,11,.818,2,23,25,5,3,3,6,13,39
102,Jared Jeffries\jeffrja01,PF,29,NYK,4,0,85,11,23,.478,0,0,,11,23,.478,.478,3,4,.750,13,7,20,1,3,7,3,7,25
103,Armon Johnson\johnsar02,PG,21,POR,2,0,0,0,0,,0,0,,0,0,,,0,0,,0,1,1,0,0,0,0,0,0
104,Chris Johnson\johnsch03,C,25,POR,4,0,19,1,1,1.000,0,0,,1,1,1.000,1.000,2,2,1.000,0,5,5,0,0,2,0,3,4
105,Joe Johnson\johnsjo02,SG,29,ATL,12,12,497,87,198,.439,18,42,.429,69,156,.442,.485,34,42,.810,18,37,55,40,13,1,31,19,226
106,Trey Johnson\johnstr01,SG,26,LAL,3,0,12,1,5,.200,0,1,.000,1,4,.250,.200,1,2,.500,1,3,4,1,0,0,0,2,3
107,Dahntay Jones\jonesda02,SG,30,IND,3,0,50,9,20,.450,0,3,.000,9,17,.529,.450,8,9,.889,2,0,2,2,1,0,3,7,26
108,James Jones\jonesja02,SF,30,MIA,12,0,272,24,51,.471,17,37,.459,7,14,.500,.637,13,13,1.000,3,27,30,2,6,2,4,24,78
109,Jason Kidd\kiddja01,PG,37,DAL,21,21,744,64,161,.398,43,115,.374,21,46,.457,.531,24,30,.800,11,84,95,153,40,10,56,36,195
110,Kyle Korver\korveky01,SG,29,CHI,16,0,276,38,98,.388,22,52,.423,16,46,.348,.500,7,7,1.000,1,18,19,17,8,3,16,35,105
111,Kosta Koufos\koufoko01,C,21,DEN,1,0,2,1,1,1.000,0,0,,1,1,1.000,1.000,0,0,,0,0,0,0,0,0,0,0,2
112,Nenad Krstic\krstine01,C,27,BOS,7,0,56,5,8,.625,0,0,,5,8,.625,.625,2,3,.667,5,7,12,2,0,4,3,8,12
113,Carl Landry\landrca01,PF,27,NOH,6,6,213,31,68,.456,0,0,,31,68,.456,.456,33,36,.917,11,19,30,6,4,3,12,25,95
114,Ty Lawson\lawsoty01,PG,23,DEN,5,5,167,26,52,.500,5,11,.455,21,41,.512,.548,21,23,.913,7,10,17,19,5,1,6,9,78
115,Jamaal Magloire\magloja01,C,32,MIA,3,0,18,2,5,.400,0,0,,2,5,.400,.400,0,0,,1,4,5,2,1,0,1,4,4
116,Ian Mahinmi\mahinia01,C,24,DAL,6,0,33,3,5,.600,0,0,,3,5,.600,.600,5,9,.556,3,3,6,0,1,0,0,16,11
117,Shawn Marion\mariosh01,SF,32,DAL,21,21,690,105,225,.467,0,5,.000,105,220,.477,.467,40,47,.851,46,87,133,45,21,19,36,53,250
118,Kenyon Martin\martike01,PF,33,DEN,5,5,148,24,50,.480,0,0,,24,50,.480,.480,11,18,.611,6,33,39,8,2,2,7,18,59
119,Roger Mason\masonro01,SG,30,NYK,3,0,55,7,18,.389,5,13,.385,2,5,.400,.528,0,0,,3,1,4,3,1,0,1,6,19
120,Wesley Matthews\matthwe02,SG,24,POR,6,6,202,27,57,.474,8,21,.381,19,36,.528,.544,16,19,.842,2,5,7,6,4,1,7,15,78
121,Eric Maynor\maynoer01,PG,23,OKC,17,0,220,29,77,.377,9,25,.360,20,52,.385,.435,15,19,.789,5,17,22,37,9,0,16,16,82
122,O.J. Mayo\mayooj01,SG,23,MEM,13,2,362,52,134,.388,20,49,.408,32,85,.376,.463,23,29,.793,10,31,41,31,11,4,17,42,147
123,Antonio McDyess\mcdyean01,PF,36,SAS,6,6,145,15,36,.417,0,0,,15,36,.417,.417,4,7,.571,10,20,30,8,2,5,7,21,34
124,Josh McRoberts\mcrobjo01,PF,23,IND,5,0,79,8,24,.333,0,1,.000,8,23,.348,.333,9,11,.818,8,10,18,6,4,1,5,17,25
125,Jodie Meeks\meeksjo01,SG,23,PHI,5,5,125,13,31,.419,8,18,.444,5,13,.385,.548,5,6,.833,2,8,10,4,3,0,2,6,39
126,Andre Miller\millean02,PG,34,POR,6,6,194,33,67,.493,4,10,.400,29,57,.509,.522,19,24,.792,5,14,19,33,2,0,13,17,89
127,Mike Miller\millemi01,SG,30,MIA,18,0,215,18,53,.340,11,37,.297,7,16,.438,.443,0,0,,9,40,49,13,7,1,8,26,47
128,Patrick Mills\millspa02,PG,22,POR,2,0,5,0,2,.000,0,1,.000,0,1,.000,.000,0,0,,0,1,1,0,0,0,1,0,0
129,Nazr Mohammed\mohamna01,C,33,OKC,14,0,148,14,34,.412,0,0,,14,34,.412,.412,4,10,.400,9,23,32,0,4,6,6,27,32
130,Troy Murphy\murphtr01,PF,30,BOS,1,0,3,0,0,,0,0,,0,0,,,0,0,,1,0,1,0,0,0,0,0,0
131,Gary Neal\nealga01,SG,26,SAS,6,0,111,17,46,.370,5,19,.263,12,27,.444,.424,7,7,1.000,2,16,18,5,1,1,2,11,46
132,Jameer Nelson\nelsoja01,PG,28,ORL,6,6,216,31,82,.378,6,26,.231,25,56,.446,.415,11,14,.786,7,18,25,30,12,0,8,14,79
133,Joakim Noah\noahjo01,C,25,CHI,16,16,529,51,124,.411,0,0,,51,124,.411,.411,37,51,.725,68,95,163,40,16,33,19,63,139
134,Andres Nocioni\nocioan01,SF,31,PHI,1,0,10,0,3,.000,0,2,.000,0,1,.000,.000,0,0,,0,2,2,0,0,0,1,1,0
135,Steve Novak\novakst01,SF,27,SAS,1,0,6,0,0,,0,0,,0,0,,,0,0,,0,1,1,0,0,0,0,0,0
136,Dirk Nowitzki\nowitdi01,PF,32,DAL,21,21,826,192,396,.485,23,50,.460,169,346,.488,.514,175,186,.941,12,159,171,53,12,13,65,46,582
137,Jermaine O'Neal\onealje01,C,32,BOS,9,9,197,21,43,.488,0,0,,21,43,.488,.488,10,11,.909,15,23,38,8,2,16,8,34,52
138,Shaquille O'Neal*\onealsh01,C,38,BOS,2,0,12,1,2,.500,0,0,,1,2,.500,.500,0,2,.000,0,0,0,1,1,0,0,4,2
139,Lamar Odom\odomla01,PF,31,LAL,10,1,286,45,98,.459,4,20,.200,41,78,.526,.480,27,38,.711,13,52,65,21,2,4,15,25,121
140,Emeka Okafor\okafoem01,C,28,NOH,6,6,188,20,31,.645,0,0,,20,31,.645,.645,4,11,.364,17,16,33,0,6,6,12,28,44
141,Zaza Pachulia\pachuza01,C,26,ATL,11,0,195,11,23,.478,0,0,,11,23,.478,.478,17,22,.773,17,37,54,13,2,1,9,37,39
142,Tony Parker\parketo01,PG,28,SAS,6,6,221,43,93,.462,1,8,.125,42,85,.494,.468,31,41,.756,1,15,16,31,8,2,20,10,118
143,Chris Paul\paulch01,PG,25,NOH,6,6,250,42,77,.545,9,19,.474,33,58,.569,.604,39,49,.796,3,37,40,69,11,0,22,11,132
144,Kendrick Perkins\perkike01,C,26,OKC,17,17,479,29,64,.453,0,0,,29,64,.453,.453,19,33,.576,37,66,103,13,4,13,27,57,77
145,Paul Pierce\piercpa01,SF,33,BOS,9,9,343,68,148,.459,21,47,.447,47,101,.465,.530,30,34,.882,5,40,45,25,12,4,24,30,187
146,Quincy Pondexter\pondequ01,SF,22,NOH,3,0,9,1,6,.167,0,3,.000,1,3,.333,.167,0,0,,0,1,1,1,0,0,0,1,2
147,Leon Powe\powele01,C,27,MEM,4,0,14,2,8,.250,0,0,,2,8,.250,.250,3,4,.750,2,2,4,0,0,0,0,0,7
148,Josh Powell\poweljo01,PF,28,ATL,9,0,48,5,9,.556,0,0,,5,9,.556,.556,0,0,,3,6,9,1,0,0,2,8,10
149,A.J. Price\priceaj01,PG,24,IND,5,0,80,13,35,.371,7,16,.438,6,19,.316,.471,9,10,.900,2,5,7,6,3,0,7,5,42
150,Zach Randolph\randoza01,PF,29,MEM,13,13,515,100,224,.446,2,8,.250,98,216,.454,.451,87,106,.821,43,98,141,31,14,10,27,45,289
151,Theo Ratliff\ratlith01,C,37,LAL,1,0,1,0,0,,0,0,,0,0,,,0,0,,0,1,1,0,0,0,0,0,0
152,J.J. Redick\redicjj01,SG,26,ORL,6,0,120,15,42,.357,1,15,.067,14,27,.519,.369,9,12,.750,0,11,11,6,1,1,7,8,40
153,Jason Richardson\richaja01,SG,30,ORL,5,5,153,17,51,.333,8,25,.320,9,26,.346,.412,8,8,1.000,5,15,20,6,3,2,3,16,50
154,Quentin Richardson\richaqu01,SF,30,ORL,6,1,98,8,15,.533,5,10,.500,3,5,.600,.700,2,2,1.000,3,12,15,2,1,1,2,9,23
155,Nate Robinson\robinna01,PG,26,OKC,3,0,12,2,7,.286,2,6,.333,0,1,.000,.429,2,2,1.000,0,0,0,1,0,0,0,1,8
156,Rajon Rondo\rondora01,PG,24,BOS,9,9,345,51,107,.477,0,3,.000,51,104,.490,.477,24,38,.632,11,38,49,86,10,0,33,16,126
157,Derrick Rose\rosede01,PG,22,CHI,16,16,649,149,376,.396,25,101,.248,124,275,.451,.430,111,134,.828,20,49,69,123,22,11,59,33,434
158,Brandon Roy\roybr01,SG,26,POR,6,0,138,22,44,.500,4,14,.286,18,30,.600,.545,8,13,.615,2,11,13,17,1,0,4,13,56
159,Brandon Rush\rushbr01,SG,25,IND,5,0,55,6,13,.462,3,4,.750,3,9,.333,.577,1,2,.500,0,7,7,3,1,1,1,5,16
160,Thabo Sefolosha\sefolth01,SG,26,OKC,17,17,344,31,67,.463,4,26,.154,27,41,.659,.493,13,13,1.000,12,41,53,12,16,5,15,24,79
161,Ish Smith\smithis01,PG,22,MEM,5,0,10,2,3,.667,0,0,,2,3,.667,.667,0,0,,0,2,2,2,1,0,1,1,4
162,J.R. Smith\smithjr01,SF,25,DEN,5,0,76,16,45,.356,9,21,.429,7,24,.292,.456,8,11,.727,1,9,10,5,2,0,8,8,49
163,Jason Smith\smithja02,C,24,NOH,6,0,58,7,15,.467,0,0,,7,15,.467,.467,0,0,,1,6,7,1,2,0,0,11,14
164,Joe Smith\smithjo02,PF,35,LAL,5,0,11,0,2,.000,0,0,,0,2,.000,.000,0,0,,1,0,1,0,0,0,0,1,0
165,Josh Smith\smithjo03,PF,25,ATL,12,12,438,69,171,.404,3,24,.125,66,147,.449,.412,40,67,.597,18,84,102,35,13,25,26,39,181
166,Marreese Speights\speigma01,C,23,PHI,2,0,21,2,12,.167,0,0,,2,12,.167,.167,0,0,,1,5,6,1,0,1,0,4,4
167,Tiago Splitter\splitti01,C,26,SAS,3,0,50,10,16,.625,0,0,,10,16,.625,.625,0,3,.000,7,7,14,1,3,1,2,4,20
168,DeShawn Stevenson\stevede01,SG,29,DAL,21,18,332,29,83,.349,27,68,.397,2,15,.133,.512,9,12,.750,1,18,19,12,11,2,10,40,94
169,Peja Stojakovic\stojape01,SF,33,DAL,19,0,350,49,120,.408,29,77,.377,20,43,.465,.529,7,9,.778,3,29,32,7,12,2,9,21,134
170,Amar'e Stoudemire\stoudam01,C,28,NYK,4,4,134,21,55,.382,0,0,,21,55,.382,.382,16,24,.667,11,20,31,7,1,3,12,10,58
171,Pape Sy\sypa01,SF,22,ATL,4,0,11,2,3,.667,0,0,,2,3,.667,.667,2,4,.500,1,0,1,3,1,0,1,1,6
172,Jeff Teague\teaguje01,PG,22,ATL,8,6,238,37,72,.514,1,7,.143,36,65,.554,.521,19,23,.826,0,17,17,28,6,3,8,10,94
173,Jason Terry\terryja01,SG,33,DAL,21,0,684,128,268,.478,42,95,.442,86,173,.497,.556,70,83,.843,6,34,40,67,26,3,32,44,368
174,Etan Thomas\thomaet01,C,32,ATL,1,0,7,0,2,.000,0,0,,0,2,.000,.000,0,0,,1,0,1,0,0,0,0,1,0
175,Kurt Thomas\thomaku01,PF,38,CHI,7,0,74,10,18,.556,0,2,.000,10,16,.625,.556,0,0,,9,10,19,3,1,3,3,12,20
176,Ronny Turiaf\turiaro01,C,28,NYK,4,4,75,8,12,.667,0,0,,8,12,.667,.667,7,10,.700,4,7,11,4,1,6,3,4,23
177,Hedo Turkoglu\turkohe01,SF,31,ORL,6,6,209,20,68,.294,7,30,.233,13,38,.342,.346,8,14,.571,1,18,19,22,8,1,7,18,55
178,Evan Turner\turneev01,SG,22,PHI,5,0,97,17,38,.447,4,5,.800,13,33,.394,.500,2,2,1.000,4,19,23,4,3,1,0,9,40
179,Greivis Vasquez\vasqugr01,SG,24,MEM,13,0,142,21,41,.512,4,11,.364,17,30,.567,.561,10,13,.769,3,16,19,25,5,2,9,11,56
180,Dwyane Wade\wadedw01,SG,29,MIA,21,21,828,181,373,.485,14,52,.269,167,321,.520,.504,139,179,.777,43,107,150,92,34,28,64,53,515
181,Von Wafer\wafervo01,SG,25,BOS,3,0,5,0,2,.000,0,1,.000,0,1,.000,.000,0,0,,0,1,1,0,0,0,0,0,0
182,Henry Walker\walkebi01,SG,23,NYK,4,0,89,9,30,.300,3,11,.273,6,19,.316,.350,2,3,.667,5,8,13,4,5,0,7,9,23
183,Gerald Wallace\wallage01,PF,28,POR,6,6,226,30,67,.448,3,17,.176,27,50,.540,.470,28,32,.875,9,46,55,17,8,3,15,19,91
184,Luke Walton\waltolu01,SF,30,LAL,1,0,4,0,2,.000,0,2,.000,0,0,,.000,0,0,,0,1,1,0,0,0,2,0,0
185,C.J. Watson\watsocj01,PG,26,CHI,16,0,136,19,56,.339,3,15,.200,16,41,.390,.366,10,11,.909,2,12,14,31,8,0,17,15,51
186,Delonte West\westde01,PG,27,BOS,9,0,170,22,47,.468,7,19,.368,15,28,.536,.543,8,10,.800,4,13,17,12,5,0,12,16,59
187,Russell Westbrook\westbru01,PG,22,OKC,17,17,638,135,343,.394,14,48,.292,121,295,.410,.414,121,142,.852,36,55,91,108,24,6,78,56,405
188,Damien Wilkins\wilkida02,SF,31,ATL,8,0,39,7,13,.538,0,2,.000,7,11,.636,.538,0,0,,3,5,8,1,2,2,2,2,14
189,Lou Williams\willilo02,SG,24,PHI,5,0,130,17,52,.327,6,20,.300,11,32,.344,.385,14,19,.737,0,8,8,15,5,0,4,6,54
190,Marvin Williams\willima02,SF,24,ATL,12,3,216,22,56,.393,3,11,.273,19,45,.422,.420,10,13,.769,10,17,27,6,9,7,12,18,57
191,Shawne Williams\willish03,PF,24,NYK,4,0,101,10,24,.417,6,14,.429,4,10,.400,.542,6,8,.750,4,10,14,5,4,4,4,8,32
192,Metta World Peace\artesro01,SF,31,LAL,9,9,287,35,79,.443,9,28,.321,26,51,.510,.500,16,21,.762,17,24,41,20,10,7,9,23,95
193,Sam Young\youngsa01,SF,25,MEM,13,11,256,43,96,.448,3,12,.250,40,84,.476,.464,9,15,.600,7,23,30,2,6,3,8,18,98
194,Thaddeus Young\youngth01,PF,22,PHI,5,0,127,25,60,.417,0,1,.000,25,59,.424,.417,7,12,.583,17,12,29,4,4,1,7,13,57